##________________##
#__________________#
____________________
____________________
____________________
____________________
____________________
____________________
__################__
____________________
____________________
__################__
____________________
____________________
____________________
____________________
____________________
____________________
#__________________#
##________________##